 34  27  27  27  27  27  27  27  27  27  27  27  27  27  27  27  27  27  27  27  27  27  27  27  27  27  33
 29   0   0   0  11   0   0   0  11   0   0   0   0   0   0   0   0   0  11   0   0   0  11   0   0   0  25
 29  10  10  10  12  10  10  10  12  10  10  10  10  10  10  10  10  10  12  10  10  10  12  10  10  10  25
 29   2   1   1   1   1   1   1   1   1   1   1   1   1   1   1   1   1   1   1   1   1   1   1   1   8  25
 29   3   0   0   0   0   0   0   0   0   0   0   0   0   0   0   0   0   0   0   0   0   0   0   0   7  25
 29   3   0   0   0   0   0   0   0   0   0   0   0   0   0   0   0   0   0   0   0   0   0   0   0   7  25
 29   3   0   0   0   0   0   0   0   0   0   0   0   0   0   0   0   0   0   0   0   0   0   0   0   7  25
 29   3   0   0   0   0   0   0   0   0   0   0   0   0   0   0   0   0   0   0   0   0   0   0   0   7  25
 29   3   0   0   0   0   0   0   0   0   0   0   0   0   0   0   0   0   0   0   0   0   0   0   0   7  25
 29   3   0   0   0   0   0   0   0   0   0   0   0   0   0   0   0   0   0   0   0   0   0   0   0   7  25
 29   3   0   0   0   0   0   0   0   0   0   0   0   0   0   0   0   0   0   0   0   0   0   0   0   7  25
 29   3   0   0   0   0   0   0   0   0   0   0   0   0   0   0   0   0   0   0   0   0   0   0   0   7  25
 29   3   0   0   0   0   0   0   0   0   0   0   0   0   0   0   0   0   0   0   0   0   0   0   0   7  25
 29   3   0   0   0   0   0   0   0   0   0   0   0   0   0   0   0   0   0   0   0   0   0   0   0   7  25
 29   3   0   0   0   0   0   0   0   0   0   0   0   0   0   0   0   0   0   0   0   0   0   0   0   7  25
 29   3   0   0   0   0   0   0   0   0   0   0   0   0   0   0   0   0   0   0   0   0   0   0   0   7  25
 29   4   5   5   5   5   5   5   5   5   5   5   5   5   5   5   5   5   5   5   5   5   5   5   5   6  25


 29  23  23  23  23  23  23  23  23  23  23  23  30   0  24  23  23  23  23  23  23  23  23  23  23  23  25
 29  -1  -1  -1  -1  -1  -1  -1  -1  -1  -1  -1  29   0  25  -1  -1  -1  -1  -1  -1  -1  -1  -1  -1  -1  25
 29  -1  -1  -1  -1  -1  -1  -1  -1  -1  -1  -1  29   0  25  -1  -1  -1  -1  -1  -1  -1  -1  -1  -1  -1  25
 29  -1  -1  -1  -1  -1  -1  -1  -1  -1  -1  -1  29   0  25  -1  -1  -1  -1  -1  -1  -1  -1  -1  -1  -1  25
 29  -1  -1  -1  -1  -1  -1  -1  -1  -1  -1  -1  29   0  25  -1  -1  -1  -1  -1  -1  -1  -1  -1  -1  -1  25

 29  34  27  27  27  27  27  27  27  27  27  27  28   0  26  27  27  27  27  27  27  27  27  27  27  27  25
 29  29   0   0   0  25  -1  -1  -1  -1  -1  -1  29   0   0   0  25  29   0   0   0   0  25  -1  -1  -1  25
 29  32  23  30   0  25  -1  -1  -1  -1  -1  -1  32  23  30   0  25  29   0  24  30   0  25  -1  -1  -1  25
 29  34  27  28   0  25  -1  -1  -1  -1  -1  34  27  33  29   0  26  28   0  25  29   0  25  -1  -1  -1  25
 29  29   0   0   0  25  -1  34  27  27  33  29   0  25  29   0   0   0   0  25  29   0  26  27  33  -1  25
 29  32  30   0  24  31  -1  29   0   0  25  29   0  25  32  23  30   0   0  25  29   0   0   0  26  27  25
 29  -1  29   0  25  -1  -1  29   0   0  26  28   0  26  27  33  29   0  24  31  32  23  30   0   0   0  25
 29  27  28   0  26  27  33  29   0   0   0   0   0   0   0  25  29   0  25  -1  -1  -1  32  30   0   0  25
 29   0   0   0   0   0  26  28   0  24  23  23  23  30   0  25  29   0  25  -1  -1  -1  -1  32  30   0  25
 29   0  24  23  30   0   0   0   0  25  -1  -1  34  28   0  25  29   0  25  -1  34  27  33  -1  32  23  25
 29   0  25  -1  29   0  24  23  23  31  -1  -1  29   0   0  26  28   0  25  -1  29   0  26  27  33  -1  25
 29   0  25  -1  29   0  25  -1  -1  -1  -1  -1  29   0   0   0   0   0  25  -1  29   0   0   0  25  -1  25
 29   0  25  -1  29   0  25  -1  -1  -1  -1  -1  32  23  23  30   0   0  25  -1  32  23  30   0  26  27  25
 29  23  31  34  28   0  26  27  27  27  27  27  27  27  27  28   0   0  25  -1  -1  34  28   0   0   0  25
 29  -1  -1  29   0   0   0   0   0   0   0   0   0   0   0   0   0   0  25  -1  -1  29   0   0   0   0  25
 29  -1  -1  29   0  24  23  23  30   0  24  23  30   0  24  30   0  24  31  -1  -1  29   0  24  30   0  25
 29  -1  -1  29   0  25  -1  -1  29   0  25  -1  29   0  25  29   0  25  -1  -1  -1  29   0  25  29   0  25
 29  27  27  28   0  25  -1  -1  29   0  25  -1  29   0  25  29   0  25  34  27  27  28   0  25  29   0  25
 29   0   0   0   0  26  33  -1  29   0  25  -1  29   0  25  29   0  25  29   0   0   0   0  25  29   0  25
 29   0   0   0  24  30  26  27  28   0  26  33  29   0  25  29   0  25  29   0  24  30   0  25  29   0  25
 29   0   0   0  25  29   0   0   0   0   0  25  29   0  26  28   0  26  28   0  25  29   0  26  28   0  25
 29  23  30   0  25  29   0  24  23  30   0  25  29   0   0   0   0   0   0   0  25  29   0   0   0   0  25
 29  27  28   0  26  28   0  25  -1  29   0  25  29   0  24  23  23  30   0  24  31  29   0  24  23  23  25
 29   0   0   0   0   0   0  25  34  28   0  25  29   0  25  -1  -1  29   0  26  27  28   0  25  -1  -1  25
 29  23  30   0  24  30   0  25  29   0   0  25  29   0  25  -1  -1  29   0   0   0   0   0  25  -1  -1  25
 29  -1  29   0  25  29   0  26  28   0  24  31  29   0  25  34  27  28   0  24  23  30   0  25  -1  -1  25
 29  -1  29   0  25  29   0   0   0   0  25  -1  29   0  25  29   0   0   0  25  -1  29   0  25  -1  -1  25
 32  23  23  23  23  23  23  23  23  23  23  23  23  23  23  23  23  23  23  23  23  23  23  23  23  23  31