 0  0  0  0  0  0  0  0  0  0  0  0  0  0  0  0  0  0  0  0  0  0  0  0  0
 2  3  4  2  3  4  2  3  4  2  3  4  2  3  4  2  3  4  2  3  4  2  3  4  2
 5  5  5  5  5  5  5  5  5  5  5  5  7  5  5  5  5  5  5  5  5  5  5  5  5
 6  6  6  6  6  6  6  6  6  6  6  6  8  6  6  6  6  6  6  6  6  6  6  6  6
20 13 14  0  0  0  0  0  0  0  0 10 12  9  0  0  0  0  0  0  0  0 20 13 14
19  1 15  0  0  0  0  0  0  0  0 10 12  9  0  0  0  0  0  0  0  0 19  1 15
19  1 15  0  0 20 13 14  0  0  0 10 12  9  0  0  0  0  0  0  0  0 19  1 15
19  1 15  0  0 19  1 15  0  0  0 10 12  9  0  0  0  0  0  0  0  0 19  1 15
19  1 15  0  0 18 17 16  0  0  0 10 12  9  0  0  0  0  0  0  0  0 19  1 15
19  1 15  0  0  0  0  0  0  0  0 10 12  9  0  0  0  0  0  0  0  0 19  1 15
19  1 15  0  0  0  0  0  0  0  0 10 12  9  0  0  0  0  0  0  0  0 19  1 15
19  1 15  0  0  0  0  0  0  0  0 10 12  9  0  0  0  0  0  0  0  0 19  1 15
19  1 15  0  0  0  0  0  0  0  0 10 12  9  0  0  0  0  0  0  0  0 19  1 15
19  1 15  0  0  0  0  0  0  0  0 10 12  9  0  0  0  0  0  0  0  0 19  1 15
19  1 15  0  0  0  0  0  0  0  0 10 12  9  0  0  0  0  0  0  0  0 19  1 15
19  1 15  0  0  0  0  0  0  0  0 10 12  9  0  0  0  0  0  0  0  0 19  1 15
19  1 15  0  0  0  0  0  0  0  0 10 12  9  0  0  0  0  0  0  0  0 19  1 15
19  1 15  0  0  0  0  0  0  0  0 10 12  9  0  0  0  0  0  0  0  0 19  1 15
19  1 15  0  0  0  0  0  0  0  0 10 12  9  0  0 20 13 14  0  0  0 19  1 15
19  1 15  0  0  0  0  0  0  0  0 10 12  9  0  0 19  1 15  0  0  0 19  1 15
19  1 15  0  0  0  0  0  0  0  0 10 12  9  0  0 18 17 16  0  0  0 19  1 15
19  1 15  0  0  0  0 20 13 14  0 10 12  9  0  0  0  0  0  0  0  0 19  1 15
19  1 15  0  0  0  0 19  1 15  0 10 12  9  0  0  0  0  0  0  0  0 19  1 15
19  1 15  0  0  0  0 18 17 16  0 10 12  9  0  0  0  0  0  0  0  0 19  1 15
18 17 16  0  0  0  0  0  0  0  0 10 12  9  0  0  0  0  0  0  0  0 18 17 16
 2  3  4  2  3  4  2  3  4  2  3  4  2  3  4  2  3  4  2  3  4  2  3  4  2
 5  5  5  5  5  5  5  5  5  5  5  5  5  5  5  5  5  5  5  5  5  5  5  5  5
