 34  27  27  27  27  27  27  27  27  27  27  27  27  27  27  27  27  27  27  27  27  27  27  27  27  27  33
 29   9   9   9   9  11   9   9  11   9   9   9  13  14  15   9   9   9  11   9   9   9  11   9   9   9  25
 29  10  10  10  10  12  10  10  12  10  10  10  16  17  18  10  10  10  12  10  10  10  12  10  10  10  25
 29   1   1   1   1   1   1   1   1   1   1   1   8   0   2   1   1   1   1   1   1   1   1   1   1   1  25
 29   0   0   0   0   0   0   0   0  19  19  19   7   0   3  19  19  19   0   0   0   0   0   0   0   0  25
 32  23  30   0   0   0   0   0   0  19   0  19  19  19  19  19   0  19   0   0   0   0   0   0  24  23  31

 -1  -1  29   0   0   0   0   0   0  19   0   0   7   0   3   0   0  19   0   0   0   0   0   0  25  -1  -1
 -1  -1  29  19  19  19  19  19  19  19   0   0   7   0   3   0   0  19  19  19  19  19  19  19  25  -1  -1
 -1  -1  32  30   0   0   0   0   0   0   0   0   7   0   3   0   0   0   0   0   0   0   0  24  31  -1  -1
 -1  -1  -1  29   0   0   0   0   0   0   0   0   7   0   3   0   0   0   0   0   0   0   0  25  -1  -1  -1
 -1  -1  -1  29   0   0   0   0   0   0   0   0   7   0   3   0   0   0   0   0   0   0   0  25  -1  -1  -1

 -1  -1  -1  32  30   0   0   0   0   0   0   0   7   0   3   0   0   0   0   0   0   0  24  31  -1  -1  -1
 -1  -1  -1  -1  29   0   0   0   0   0   0   0   7   0   3   0   0   0   0   0   0   0  25  -1  -1  -1  -1
 -1  -1  -1  -1  29   0   0   0   0   0   0   0   7   0   3   0   0   0   0   0   0   0  25  -1  -1  -1  -1
 -1  -1  -1  -1  32  30  19   0   0   0   0   0   7   0   3   0   0   0   0   0  19  24  31  -1  -1  -1  -1
 -1  -1  -1  -1  -1  29  19   0   0   0   0   0   7   0   3   0   0   0   0   0  19  25  -1  -1  -1  -1  -1

 -1  -1  -1  -1  -1  29  19   0   0   0   0   0   7   0   3   0   0   0   0   0  19  25  -1  -1  -1  -1  -1
 -1  -1  -1  -1  -1  29  19   0   0   0   0   0   7   0   3   0   0   0   0   0  19  25  -1  -1  -1  -1  -1
 -1  -1  -1  -1  -1  29  19   0   0   0   0   0   7   0   3   0   0   0   0   0  19  25  -1  -1  -1  -1  -1
 -1  -1  -1  -1  -1  29  19   0   0   0   0   0   7   0   3   0   0   0   0   0  19  25  -1  -1  -1  -1  -1
 -1  -1  -1  -1  -1  29  19   0   0   0   0   0   7   0   3   0   0   0   0   0  19  25  -1  -1  -1  -1  -1

 -1  -1  -1  -1  -1  32  23  30  19   0   0  19   7   0   3  19   0   0  19  24  23  31  -1  -1  -1  -1  -1
 -1  -1  -1  -1  -1  -1  -1  29   0  19   0  19   7   0   3  19   0  19   0  25  -1  -1  -1  -1  -1  -1  -1
 -1  -1  -1  -1  -1  -1  -1  29   0  19   0   0   7   0   3   0   0  19   0  25  -1  -1  -1  -1  -1  -1  -1
 -1  -1  -1  -1  -1  -1  -1  29   0  19   0   0   7   0   3   0   0  19   0  25  -1  -1  -1  -1  -1  -1  -1
 34  27  27  27  33  -1  -1  29   0   0  19  19  19  19  19  19  19   0   0  25  -1  -1  34  27  27  27  33

 29   0   0   0  25  -1  -1  29   0   0   0   0   7   0   3  19   0   0   0  25  -1  -1  29   0   0   0  25
 29   0   0   0  25  -1  -1  29   0   0   0   0   7   0   3   0   0   0   0  25  -1  -1  29   0   0   0  25
 29   0   0   0  25  -1  -1  29  19  19  19  19  19  19  19  19  19  19  19  25  -1  -1  29   0   0   0  25
 29   0   0   0  25  -1  -1  29   0   0   0   0   7   0   3   0   0   0   0  25  -1  -1  29   0   0   0  25
 29   0   0   0  25  -1  -1  29  19  19  19  19  19  19  19  19  19  19  19  25  -1  -1  29   0   0   0  25

 29   0   0   0  26  27  27  28   0   0   0   0   7   0   3   0   0   0   0  26  27  27  28   0   0   0  25
 29   0   0   0   0   0   0   0   0   0   0   0   7   0   3   0   0   0   0   0   0   0   0   0   0   0  25
 29   0   0   0   0   0   0   0   0   0   0   0   7   0   3   0   0   0   0   0   0   0   0   0   0   0  25
 29   0   0  19   0   0   0  19   0   0   0   0   7   0   3   0   0   0   0  19   0   0   0  19   0   0  25
 29   0   0   0  19   0  19   0   0   0   0   0   7   0   3   0   0   0   0   0  19   0  19   0   0   0  25
 29   0   0   0   0  19   0   0   0   0   0   0   7   0   3   0   0   0   0   0   0  19   0   0   0   0  25
 29   0   0   0  19   0  19   0   0   0   0   0   7   0   3   0   0   0   0   0  19   0  19   0   0   0  25
 29   0   0  19   0   0   0  19   0   0   0   0   7   0   3   0   0   0   0  19   0   0   0  19   0   0  25
 29   0   0   0   0   0   0   0   0   0   0   0   7   0   3   0   0   0   0   0   0   0   0   0   0   0  25
 29   0   0   0   0   0   0   0   0   0   0   0   7   0   3   0   0   0   0   0   0   0   0   0   0   0  25
 32  23  23  23  23  23  23  23  23  23  23  23  23  23  23  23  23  23  23  23  23  23  23  23  23  23  31
