 34  27  27  27  27  27  27  27  27  27  27  27  27  27  27  27  27  27  27  27  27  27  27  27  27  27  33
 29   9   9  13  14  15   9   9  11   9   9   9   9   9   9   9   9   9  11   9   9   9  11   9   9   9  25
 29  10  10  16  17  18  10  10  12  10  10  10  10  10  10  10  10  10  12  10  10  10  12  10  10  10  25
 29   0   0   0   3   0   0   0   0   0   0   0   0   0   0   0   7   0   0   0   0   3   0   0   0   0  25
 29   0   0   0   3   0   0   0   0   0   0   0   0   0   0   0   7   0   0   0   0   3   0   0   0   0  25
 29   0   0   0   3   0   0   0   0   0   0   0   0   0   0   0   7   0   0   0   0   3   0   0   0   0  25

 29   0   0   0   3   0   0   0   0   0   0   0   0   0   0   0   7   0   0   0   0   3   0   0   0   0  25
 29   0   0   0   4   5   5   5   5   5   5   5   5   5   5   5   6   0   0   0   0   3   0   0   0   0  25
 29   0   0   0   0   0   0   0   0   0   0   0   0   0   0   0   0   0   0   0   0   3   0   0   0   0  25
 29   0   0   0   0   0   0   0   0   0   0   0   0   0   0   0   0   0   0   0   0   3   0   0   0   0  25
 29   0   0   0   0   0   0   0   0   0   0   0   0   0   0   0   0   0   0   0   0   3   0   0   0   0  25

 29   0   0   0   0   0   0   0   0   0   0   0   0   0   0   0   0   0   0   0   0   3   0   0   0   0  25
 32  23  23  23  23  23  23  23  23  23  23  23  23  23  23  23  30   0   0   0   0   3   0   0   0   0  25
 -1  -1  -1  -1  -1  -1  -1  -1  -1  -1  -1  -1  -1  -1  -1  -1  29   0   0   0   0   3   0   0   0   0  25
 -1  -1  -1  -1  -1  -1  -1  -1  -1  -1  -1  -1  -1  -1  -1  -1  29   0   0   0   0   3   0   0   0   0  25
 -1  -1  -1  -1  -1  -1  -1  -1  -1  -1  -1  -1  -1  -1  -1  -1  29   0   0   0   0   3   0   0   0   0  25
 -1  -1  -1  -1  -1  -1  -1  -1  -1  -1  -1  -1  -1  -1  -1  -1  29   0   0   0   0   3   0   0   0   0  25
 -1  -1  -1  -1  -1  -1  -1  -1  -1  -1  -1  -1  -1  -1  -1  -1  29   0   0   0   0   3   0   0   0   0  25
 -1  -1  -1  -1  -1  -1  -1  -1  -1  -1  -1  -1  -1  -1  -1  -1  29   0   0   0   0   3   0   0   0   0  25
 -1  -1  -1  -1  -1  -1  -1  -1  -1  -1  -1  -1  -1  -1  -1  -1  29   0   0   0   0   3   0   0   0   0  25
 -1  -1  -1  -1  -1  -1  -1  -1  -1  -1  -1  -1  -1  -1  -1  -1  29   0   0   0   0   3   0   0   0   0  25
 -1  -1  -1  -1  -1  -1  -1  -1  -1  -1  -1  -1  -1  -1  -1  -1  29   0   0   0   0   3   0   0   0   0  25
 -1  -1  -1  -1  -1  -1  -1  -1  -1  -1  -1  -1  -1  -1  -1  -1  29   0   0   0   0   3   0   0   0   0  25
 -1  -1  -1  -1  -1  -1  -1  -1  -1  -1  -1  -1  -1  -1  -1  -1  29   0   0   0   0   3   0   0   0   0  25
 -1  -1  -1  -1  -1  -1  -1  -1  -1  -1  -1  -1  -1  -1  -1  -1  29   0   0   0   0   3   0   0   0   0  25
 -1  -1  -1  -1  -1  -1  -1  -1  -1  -1  -1  -1  -1  -1  -1  -1  29   0   0   0   0   3   0   0   0   0  25
 -1  -1  -1  -1  -1  -1  -1  -1  -1  -1  -1  -1  -1  -1  -1  -1  29   0   0   0   0   3   0   0   0   0  25
 -1  -1  -1  -1  -1  -1  -1  -1  -1  -1  -1  -1  -1  -1  -1  -1  29   0   0   0   0   3   0   0   0   0  25
 -1  -1  -1  -1  -1  -1  -1  -1  -1  -1  -1  -1  -1  -1  -1  -1  29   0   0   0   0   3   0   0   0   0  25
 34  27  27  27  27  27  27  27  27  27  27  27  27  27  27  27  28   0   0   0   0   4   5   5   5   5  25

 29   0   0   0   0   0   0   0   0   0   0   0   0   0   0   0   0   0   0   0   0   0   0   0   0   0  25
 29   0   0   0   0   0   0   0   0   0   0   0   0   0   0   0   0   0   0   0   0   0   0   0   0   0  25
 29   0   0   0   0   0   0   0   0   0   0   0   0   0   0   0   0   0   0   0   0   0   0   0   0   0  25
 29   0   0   0   0   0   0   0   0   0   0   0   0   0   0   0   0   0   0   0   0   0   0   0   0   0  25
 29   0   0   0   0   0   0   0   0   0   0   0   0   0   0   0   0   0   0   0   0   0   0   0   0   0  25
 29   0   0   0   2   1   1   1   1   1   1   1   1   1   1   1   1   1   1   1   1   1   1   1   1   1  25

 29   0   0   0   3   0   0   0   0   0   0   0   0   0   0   0   0   0   0   0   0   0   0   0   0   0  25
 29   0   0   0   3   0   0   0   0   0   0   0   0   0   0   0   0   0   0   0   0   0   0   0   0   0  25
 29   0   0   0   3   0   0   0   0   0   0   0   0   0   0   0   0   0   0   0   0   0   0   0   0   0  25
 29   0   0   0   3   0   0   0   0   0   0   0   0   0   0   0   0   0   0   0   0   0   0   0   0   0  25
 29   0   0   0   3   0   0   0   0   0   0   0   0   0   0   0   0   0   0   0   0   0   0   0   0   0  25

 32  23  23  23  23  23  23  23  23  23  23  23  23  23  23  23  23  23  23  23  23  23  23  23  23  23  31



